#######################################
# Syntax Coloring Map For the current project.
# This file was generated by doxygen2keywords.xsl.
#######################################

#######################################
# Classes and structs (KEYWORD1)
#######################################

GeoluxCamera	KEYWORD1

#######################################
# Methods (KEYWORD2)
#######################################

GeoluxCamera	KEYWORD2
~GeoluxCamera	KEYWORD2
begin	KEYWORD2
begin	KEYWORD2
begin	KEYWORD2
begin	KEYWORD2
takeSnapshot	KEYWORD2
getStatus	KEYWORD2
getImageSize	KEYWORD2
getImageChunk	KEYWORD2
transferImage	KEYWORD2
transferImage	KEYWORD2
restart	KEYWORD2
printCameraInfo	KEYWORD2
printCameraInfo	KEYWORD2
getDeviceType	KEYWORD2
getCameraFirmware	KEYWORD2
getCameraSerialNumber	KEYWORD2
runAutofocus	KEYWORD2
setResolution	KEYWORD2
getResolution	KEYWORD2
setQuality	KEYWORD2
getQuality	KEYWORD2
setJPEGMaximumSize	KEYWORD2
getJPEGMaximumSize	KEYWORD2
setNightMode	KEYWORD2
setNightMode	KEYWORD2
getNightMode	KEYWORD2
setIRLEDMode	KEYWORD2
setIRLEDMode	KEYWORD2
getIRLEDMode	KEYWORD2
getIRFilterStatus	KEYWORD2
setAutofocusPoint	KEYWORD2
getAutofocusX	KEYWORD2
getAutofocusY	KEYWORD2
setAutoexposureRegion	KEYWORD2
getAutoexposureX	KEYWORD2
getAutoexposureY	KEYWORD2
getAutoexposureWidth	KEYWORD2
getAutoexposureHeight	KEYWORD2
getExposureTime	KEYWORD2
getImageBrightness	KEYWORD2
setWhiteBalanceOffset	KEYWORD2
getWhiteBalanceOffsetRed	KEYWORD2
getWhiteBalanceOffsetGreen	KEYWORD2
getWhiteBalanceOffsetBlue	KEYWORD2
setColorCorrectionMode	KEYWORD2
getColorCorrectionMode	KEYWORD2
setAutoSnapshotInterval	KEYWORD2
getAutoSnapshotInterval	KEYWORD2
moveFocus	KEYWORD2
getFocusPosition	KEYWORD2
moveZoom	KEYWORD2
getZoomPosition	KEYWORD2
sleep	KEYWORD2
sendCommand	KEYWORD2
waitForReady	KEYWORD2
waitResponse	KEYWORD2
waitResponse	KEYWORD2
waitResponse	KEYWORD2
streamWrite	KEYWORD2
streamWrite	KEYWORD2
streamDump	KEYWORD2
streamFind	KEYWORD2
getCameraInfoString	KEYWORD2
getCameraInfoInt	KEYWORD2

#######################################
# Constants (LITERAL1)
#######################################

OK	LITERAL1
ERROR	LITERAL1
BUSY	LITERAL1
NONE	LITERAL1
DAY	LITERAL1
NIGHT	LITERAL1
AUTO	LITERAL1
IR_ON	LITERAL1
IR_OFF	LITERAL1
IR_AUTO	LITERAL1
DEFAULT_XFER_CHUNK_SIZE	LITERAL1
GEOLUX_CAMERA_RS232_BAUD	LITERAL1
GEOLUX_CAMERA_RS232_CONFIG	LITERAL1
GEOLUX_PROGMEM	LITERAL1
GFP	LITERAL1
GF	LITERAL1
DBG_GLX	LITERAL1
